17 17 0 0 16 16
G G G G S S S S S S S S S S S S S
G G G G G G G G G G G G G G G S S
G G G G G G G G G G G G G G G G S
G G G G G G G G G G G G G G G G S
G G G G G G G G G G G G G G G G S
G G G G G G G G G G G G G G G G S
G G G G G G G G G G G G G G G G S
S G G G G G G G G G G G G G G G S
S G G G G G G G G G G G G G G G S
S G G G G G G G G G G G G G G G S
S G G G G G G G G G G G G G G G S
S G G G G G G G G G G G G G G S S
S G G G G G G G G G G G G G G G S
S G G G G G G G G G G G G G G G S
S G G G G G G G G G G G G G G G S
S G G G G G G G G G G G G G G M S
S S S S S S S S S S S S S S S S S 

